全球時尚專業彩妝品牌M.A.C全新春妝「孔雀彩妝系列」搶眼登場。靈感來自於2011春夏趨勢中的「冰紛夢幻-ICE-DREAM」，以「超光感眼影」飽合閃亮的金屬光澤，透過美麗的大面積色澤暈染，讓眼神流轉間流露令人難以抗拒的女人味，再擦上全新款「親吻唇霜」，讓雙唇呈現色澤明亮飽和，有如乳霜般綿密而又保有閃亮的光澤質感，展現雙唇可口誘人讓人非吻不可的魅力！

超光感眼影是一款超持久的眼影，由金屬光澤粉末組成，可提供反光、強烈的金屬光潤飾效果，打造閃閃發亮的動人眼神。獨特維他命A & E滋養配方，可調理細緻的眼睛部肌膚，讓肌膚平滑不起皺，維持最完美的光滑妝效。細膩的金屬光感粉末可確保上妝滑順、勻稱，閃耀光澤持續一整天！
 
親吻唇霜是M.A.C全新研發的”液狀唇膏”！！把唇膏液體化，就像一支溶化的唇膏，不但可立即改變唇色，充滿水感的保濕配方更可以創造出獨一無二的唇部妝效！親吻唇霜擁有唇膏般持色顯色的特性，結合唇蜜水潤閃耀的質感，輕輕一搽就能夠創造飽和的色彩效果。獨特的舒適配方更能夠帶給雙唇從未體驗過、有如包覆絲緞一般的綿密柔潤感！獨創有如棉花糖般的唇妝效果，如空氣般輕盈、閃耀著水光的亮澤感，打造讓人不由得想親吻的甜蜜美唇！全新限量的特殊筆狀窄長型包裝，可以輕鬆優雅的收藏在化妝包或是晚宴包中，隨時創造雙唇耀眼的美麗！
M.A.C全球資深彩妝師維克多．森柏林（Victor Cembellin）傳授如何利用親吻唇霜打造棉花糖唇妝的密技！

STEP 1：搽上專業護唇膏SPF 15，靜待一會，讓唇吸收。
STEP 2：先用 Whirl唇線造型筆勾勒唇型，再用 #219 唇刷從嘴角向中央暈勻，創造均勻潤飾的效果。
STEP 3：想要有完美的棉花糖粉紅，可在整個唇上搽上 Enchantee (淺粉藍色)親吻唇霜。
親吻唇霜 NT 700 5g
Enchantee – 淺粉藍色
Woo Me – 淺粉裸色
So Vain – 淺珊瑚色
Vanity Fair – 淺粉藍色
Exxxhibitionist – 珊瑚紅
Strut Your Stuff – 亮紅色
Scandelicious – 藍紫紅色
Peacocky – 含紅色珍珠星塵的天空藍
Super – 淺棕色
Temper Tantra – 淺紅棕色 
超光感眼影 NT 750  2.2g
Peek-at-You – 黃白色
Dalliance – 淺香檳色
Prance – 粉霜淺紫珍珠色
Top of the Posh – 粉白色
Tweet Me – 金古銅色
Mating Call – 淺粉霜紫羅藍色
Odalisque – 深藍綠色
Sexpectations – 金屬酒紅色
Paparazz-she – 深銅色
Spectacle of Yourself – 深古銅色
Centre Stage – 粉霜巧克力棕
Unflappable – 紫色珍珠星塵粉霜
